20,120
J,1
RV,RV,RW,RW,RH,RH
GV,GV,GW,GW,GH,GH
YV,YV,YW,YW,YH,YH
PV,PV,PW,PW,PH,PH
BV,BV,BW,BW,BH,BH
B,R,G,Y,P,M