15,120
B,20
R,R,R,B,P,G
P,R,G,B,B,B
G,P,B,Y,Y,R
G,B,R,P,R,Y
R,G,B,B,R,B
B,P,G,P,Y,P