20,120
B,30
R,R,B,B,P,G
P,R,G,B,Y,B
G,P,B,Y,Y,R
G,B,RV,PW,R,Y
R,G,P,B,B,P
B,P,Y,P,G,P