M,18,50,190
M,M,M,M,M,M
R,R,G,R,Y,R
Y,R,G,P,B,P
P,Y,YV,M,R,P
M,M,M,M,M,M
M,M,M,M,M,M