L
16,75
B,15
Q,R,Q,B,P,G
P,RZ,G,B,Y,B
G,P,R,Y,B,R
G,R,B,P,B,Y
R,B,R,G,B,G
B,P,R,R,R,R