16,75
B,15
Q,G,R,B,P,G
P,M,R,B,Y,B
G,P,B,R,R,G
G,B,R,P,R,Y
R,G,P,B,B,P
B,P,Y,G,R,R