30,220
B,15,R,15,P,15
R,B,G,Y,P,P
Y,P,G,R,B,G
P,Y,P,G,R,B
G,B,R,Y,P,Y
B,P,R,G,Y,R
G,Y,Y,R,B,P