M,18,50,190
R,R,G,R,Y,R
Y,R,G,P,B,P
P,Y,YV,M,R,P
M,M,M,M,M,M
M,M,M,M,M,M
M,M,M,M,M,M