C
16,75
B,15
R,R,G,B,P,G
P,R,G,B,Y,B
G,P,R,GV,BW,R
G,R,B,P,P,Y
R,B,R,G,R,G
B,P,R,R,G,R