20,120
B,3,R,3,P,3
RV,RV,RV,RH,RH,RH
GV,GV,GV,GH,GH,GH
YV,YV,YV,YH,YH,YH
PV,PV,PV,PH,PH,PH
BV,BV,BV,BH,BH,BH
B,B,B,B,B,B