C
20,90
Y,10,P,10,R,10
B,Y,P,G,G,R
P,G,B,R,Y,P
R,P,G,B,Y,G
Y,G,P,R,B,Y
B,R,Y,G,P,B
G,B,R,Y,P,Y