16,75
B,15
Q,R,Q,B,P,G
P,RZ,RV,B,Y,B
G,P,B,Y,Y,R
G,B,R,P,R,Y
R,G,P,B,B,P
B,P,Y,G,R,R